1111111111111111111111111111111111
1E1000000000000C00000C000000000001
1010010100010000010100100000010111
1010010010101111111101000000010111
100000000C00C1C000000100000001C0P1
1111111111111111111111111111111111